POS,REF,ALT,AD_REF.LOW,AD_ALT.LOW,DP.LOW,SNPindex.LOW,AD_REF.HIGH,AD_ALT.HIGH,DP.HIGH,location,ref codon,alt codon,codon_change
122377,C,T,0,48,48,1,8,7,15,GrBNV gp33-like protein CDS,L,L,no
122463,C,T,0,48,48,1,18,6,24,GrBNV gp33-like protein CDS,R,R,no
123223,G,A,1,105,106,0.990566038,17,2,19,ODV-E56 CDS,G,G,no
123319,G,T,51,32,83,0.385542169,24,0,24,ODV-E56 CDS,L,L,no
123601,G,T,1,73,74,0.986486486,17,2,19,ODV-E56 CDS,S,S,no
138144,T,C,0,56,56,1,12,3,15,vp91 CDS,N,D,yes
138524,A,T,33,0,33,0,4,8,12,p-loop NTPase CDS,N,Y,yes
138891,T,C,24,27,51,0.529411765,18,0,18,GrBNV gp43-like protein CDS,N,N,no
139171,T,G,0,42,42,1,10,3,13,GrBNV gp43-like protein CDS,Y,D,yes
139398,T,C,0,41,41,1,18,1,19,GrBNV gp43-like protein CDS,Y,Y,no
139665,A,G,57,0,57,0,8,9,17,GrBNV gp43-like protein CDS,A,A,no
139848,A,C,0,44,44,1,20,1,21,GrBNV gp43-like protein CDS,E,D,yes
139876,A,G,0,46,46,1,22,0,22,GrBNV gp43-like protein CDS,T,A,yes
144408,C,A,0,45,45,1,14,0,14,RR2 CDS,R,L,yes